bbbbbbbbbbbbbbbbbbbbbbbbbbbbbbbbbbbbbbbbbbbbbbbbbbbbbbbbbbbbbbbb
b------------------------------bb------------------------------b
b------------------------------bb------------------------------b
b------------------------------bb------------------------------b
b------------------------------bb------------------------------b
b------------------------------bb------------------------------b
b------------------------------bb------------------------------b
b------------------------------bb------------------------------b
b------------------------------bb------------------------------b
b------------------------------bb------------------------------b
b------------------------------bb------------------------------b
b------------------------------bb------------------------------b
b------------------------------bb------------------------------b
b------------------------------bb------------------------------b
b------------------------------bb------------------------------b
b------------------------------bb------------------------------b
b------------------------------bb------------------------------b
b------------------------------bb------------------------------b
b------------------------------bb------------------------------b
b------------------------------bb------------------------------b
b------------------------------bb------------------------------b
b------------------------------bb------------------------------b
b------------------------------bb------------------------------b
b------------------------------bb------------------------------b
b------------------------------bb------------------------------b
b-------------------------b----bb------------------------------b
b-------------------------b----bb------------------------------b
b-------------bbbbbbb--bbbbbbbbbb------------------------------b
b-b-----------------b------------------------------------------b
b-b-----------------b------------------------------------------b
bGGGGGGGGGGGGGGGGGGGGGGGGGGGGGGGGGGGGGGGGGGGGGGGGGGGGGGGGGGGGGGb
bggggggggggggggggggggggggggggggggggggggggggggggggggggggggggggggb
