bbbbbbbbbbbbbbbbbbbbbbbbbbbbbbbbbbbbbbbbbbbbbbbbbbbbbbbbbbbbbbbb
b------------------------------bb------------------------------b
b------------------------------bb------------------------------b
b------------------------------bb------------------------------b
b------------------------------bb------------------------------b
b------------------------------bb------------------------------b
b------------------------------bb------------------------------b
b------------------------------bb------------------------------b
b------------------------------bb------------------------------b
b------------------------------bb------------------------------b
b------------------------------bb------------------------------b
b------------------------------bb------------------------------b
b------------------------------bb------------------------------b
b------------------------------bb------------------------------b
b------------------------------bb------------------------------b
b------------------------------bb------------------------------b
b------------------------------bb------------------------------b
b------------------------------bb------------------------------b
b------------------------------bb------------------------------b
b------------------------------bb------------------------------b
b------------------------------bb------------------------------b
b------------------------------bb------------------------------b
b------------------------------bb------------------------------b
b------------------------------bb------------------------------b
b------------------------------bb------------------------------b
b--------------------------------------------------------------b
b--------------------------------------------------------------b
b-------------bbbbbbb--bbbbb--bbb------------------------------b
b-b-----------------b------------------------------------------b
b-b-----------------b------------------------------------------b
bGGGGGGGGGGGGGGGGGGGGGGGGGGGGGGGGGGGGGGGGGGGGGGGGGGGGGGGGGGGGGGb
bggggggggggggggggggggggggggggggggggggggggggggggggggggggggggggggb
