fffffffffffffffffffff
f                   f
f    b     b     b  f
f        b     b    f
f                   f
f   b   b     b     f
f     b        b    f
fffffffffffbfffffffff
