bbbbbbbbbbbbbbbbbbbbbbbbbbbbbbbb
b------------------------------b
b------------------------------b
b------------------------------b
b------------------------------b
b------------------------------b
b------------------------------b
b------------------------------b
b------------------------------b
b------------------------------b
b------------------------------b
b------------------------------b
b------------------------------b
b------------------------------b
b------------------------------b
b------------------------------b
b------------------------------b
b------------------------------b
b------------------------------b
b------------------------------b
b------------------------------b
b------------------------------b
b------------------------------b
b------------------------------b
b------------------------------b
b-------------------------b----b
b-------------------------b----b
b-------------bbbbbbb--bbbbbbbbb
b------------------------------b
b------------------------------b
bGGGGGGGGGGGGGGGGGGGGGGGGGGGGGGb
bggggggggggggggggggggggggggggggb
