bbbbbbbbbbbbbbbbbbbbbbbbbbbbbbbbb
b------------------------------bb
b------------------------------bb
b------------------------------bb
b------------------------------bb
b------------------------------bb
b------------------------------bb
b------------------------------bb
b------------------------------bb
b------------------------------bb
b------------------------------bb
b------------------------------bb
b------------------------------bb
b------------------------------bb
b------------------------------bb
b------------------------------bb
b------------------------------bb
b------------------------------bb
b------------------------------bb
b------------------------------bb
b------------------------------bb
b------------------------------bb
b------------------------------bb
b------------------------------bb
b------------------------------bb
b-------------------------------b
b-------------------------------b
b-------------bbbbbbb--bbbbb--bbb
b-b-----------------b-----------b
b-b-----------------b-----------b
bGGGGGGGGGGGGGGGGGGGGGGGGGGGGGGGb
bgggggggggggggggggggggggggggggggb
